#,#,#,#,#,#,#,#,#,#,#,#,#,#,#,#,#,#,#,#,#,#,#,#,#,#,#,#,#,#,#,#,#,#,#,#,#,#,#,#,#,#,#,#,#,#,#,#,#,#,#,#,#,#,#,#,#,#,#,#,#,#,#,#,#,#,#,#,#,#,#,#,#,#,#,#,#,#,#,#,#,#,#,#,#,#,#,#,#,#,#,#,#,#,#,#,#,#,#,#
#,s,#,.,.,.,.,.,.,.,.,.,.,.,.,.,#,.,.,.,.,.,#,.,.,.,.,.,.,.,#,.,.,.,.,.,.,.,.,.,.,.,.,.,#,.,.,.,.,.,.,.,.,.,.,.,.,.,.,.,.,.,.,.,.,.,.,.,.,.,.,.,#,.,.,.,.,.,.,.,.,.,.,.,#,.,.,.,#,.,.,.,#,.,.,.,.,.,#,#
#,.,#,.,#,#,#,#,#,#,#,#,#,#,#,.,#,.,#,#,#,.,#,#,#,#,#,.,#,.,#,#,#,.,#,#,#,#,#,.,#,#,#,.,#,.,#,#,#,#,#,.,#,#,#,#,#,#,#,#,#,#,#,#,#,#,#,#,#,#,#,.,#,#,#,#,#,.,#,#,#,#,#,.,#,.,#,.,#,.,#,.,#,.,#,.,#,#,#,#
#,.,.,.,#,.,.,.,.,.,#,.,.,.,.,.,#,.,.,.,#,.,.,.,.,.,#,.,#,.,.,.,#,.,.,.,#,.,.,.,#,.,#,.,#,.,#,.,.,.,#,.,.,.,#,.,.,.,.,.,.,.,.,.,#,.,.,.,.,.,#,.,.,.,.,.,#,.,.,.,#,.,#,.,#,.,#,.,.,.,#,.,#,.,#,.,.,.,#,#
#,#,#,#,#,.,#,#,#,.,#,.,#,#,#,#,#,.,#,.,#,#,#,#,#,.,#,.,#,#,#,.,#,#,#,.,#,.,#,#,#,.,#,.,#,.,#,.,#,#,#,#,#,.,#,.,#,#,#,#,#,#,#,#,#,.,#,.,#,.,#,#,#,#,#,.,#,.,#,.,#,.,#,.,#,.,#,#,#,#,#,.,#,#,#,#,#,.,#,#
#,.,.,.,#,.,.,.,#,.,.,.,#,.,#,.,.,.,#,.,#,.,.,.,#,.,.,.,#,.,.,.,#,.,.,.,#,.,.,.,#,.,#,.,#,.,.,.,#,.,.,.,.,.,#,.,.,.,.,.,.,.,.,.,.,.,#,.,#,.,.,.,#,.,#,.,#,.,#,.,#,.,.,.,.,.,#,.,.,.,#,.,#,.,.,.,#,.,#,#
#,.,#,.,#,#,#,.,#,#,#,#,#,.,#,.,#,#,#,.,#,.,#,#,#,#,#,#,#,.,#,#,#,.,#,#,#,#,#,.,#,.,#,.,#,#,#,#,#,.,#,#,#,#,#,.,#,#,#,#,#,#,#,#,#,#,#,.,#,#,#,.,#,.,#,.,#,.,#,.,#,#,#,#,#,#,#,#,#,.,#,.,#,.,#,.,#,.,#,#
#,.,#,.,.,.,#,.,#,.,.,.,#,.,.,.,#,.,.,.,#,.,.,.,.,.,.,.,.,.,.,.,#,.,#,.,.,.,.,.,#,.,.,.,#,.,.,.,.,.,#,.,.,.,#,.,#,.,.,.,.,.,.,.,.,.,#,.,.,.,#,.,.,.,#,.,#,.,#,.,.,.,.,.,.,.,.,.,#,.,#,.,#,.,#,.,.,.,#,#
#,#,#,.,#,#,#,.,#,.,#,.,#,.,#,#,#,.,#,#,#,#,#,.,#,#,#,#,#,#,#,.,#,#,#,.,#,#,#,#,#,.,#,#,#,.,#,#,#,#,#,.,#,#,#,.,#,.,#,#,#,#,#,.,#,.,#,#,#,.,#,#,#,.,#,.,#,.,#,#,#,#,#,#,#,#,#,.,#,.,#,.,#,.,#,#,#,#,#,#
#,.,.,.,#,.,.,.,#,.,#,.,#,.,.,.,#,.,.,.,.,.,#,.,#,.,.,.,#,.,#,.,.,.,.,.,#,.,.,.,#,.,.,.,.,.,#,.,.,.,.,.,#,.,.,.,#,.,#,.,.,.,#,.,#,.,#,.,#,.,.,.,#,.,#,.,#,.,.,.,#,.,.,.,.,.,.,.,#,.,.,.,#,.,.,.,.,.,#,#
#,.,#,#,#,.,#,#,#,.,#,.,#,#,#,.,#,#,#,#,#,.,#,.,#,.,#,.,#,.,#,#,#,#,#,#,#,.,#,.,#,#,#,#,#,#,#,.,#,.,#,#,#,.,#,#,#,.,#,.,#,.,#,.,#,.,#,.,#,#,#,.,#,#,#,.,#,#,#,#,#,.,#,#,#,#,#,#,#,.,#,#,#,.,#,#,#,.,#,#
#,.,.,.,#,.,#,.,#,.,#,.,.,.,#,.,.,.,#,.,.,.,#,.,#,.,#,.,#,.,.,.,#,.,.,.,.,.,#,.,#,.,.,.,.,.,#,.,#,.,.,.,#,.,#,.,#,.,#,.,#,.,#,.,#,.,.,.,#,.,#,.,.,.,.,.,#,.,.,.,.,.,#,.,.,.,.,.,#,.,.,.,#,.,.,.,#,.,#,#
#,.,#,.,#,.,#,.,#,.,#,#,#,.,#,.,#,#,#,.,#,#,#,#,#,.,#,.,#,.,#,#,#,.,#,#,#,#,#,.,#,.,#,.,#,.,#,#,#,#,#,.,#,.,#,.,#,.,#,#,#,.,#,.,#,#,#,.,#,.,#,#,#,#,#,#,#,.,#,#,#,#,#,.,#,#,#,.,#,#,#,.,#,#,#,#,#,.,#,#
#,.,#,.,.,.,#,.,#,.,#,.,#,.,.,.,#,.,.,.,#,.,.,.,.,.,#,.,#,.,.,.,.,.,#,.,.,.,#,.,#,.,#,.,#,.,.,.,.,.,.,.,#,.,#,.,.,.,.,.,.,.,#,.,.,.,#,.,#,.,.,.,.,.,#,.,.,.,#,.,.,.,.,.,#,.,#,.,.,.,#,.,.,.,.,.,.,.,#,#
#,.,#,#,#,#,#,.,#,.,#,.,#,#,#,#,#,.,#,#,#,.,#,#,#,#,#,.,#,.,#,#,#,#,#,.,#,.,#,.,#,.,#,.,#,#,#,#,#,.,#,#,#,.,#,.,#,#,#,#,#,#,#,#,#,.,#,.,#,#,#,.,#,.,#,#,#,.,#,.,#,#,#,#,#,.,#,.,#,.,#,#,#,#,#,#,#,.,#,#
#,.,#,.,.,.,.,.,#,.,.,.,#,.,.,.,#,.,.,.,.,.,#,.,.,.,#,.,#,.,#,.,.,.,.,.,#,.,#,.,.,.,#,.,.,.,#,.,.,.,#,.,.,.,#,.,#,.,.,.,.,.,.,.,.,.,#,.,.,.,.,.,#,.,.,.,.,.,#,.,.,.,.,.,.,.,#,.,#,.,#,.,#,.,.,.,#,.,#,#
#,.,#,#,#,.,#,#,#,#,#,.,#,.,#,.,#,#,#,#,#,#,#,.,#,.,#,.,#,.,#,.,#,#,#,#,#,#,#,#,#,.,#,#,#,.,#,#,#,.,#,.,#,#,#,.,#,.,#,#,#,#,#,#,#,#,#,#,#,#,#,#,#,#,#,#,#,#,#,#,#,#,#,#,#,#,#,.,#,.,#,.,#,.,#,.,#,.,#,#
#,.,.,.,#,.,#,.,.,.,.,.,#,.,#,.,#,.,.,.,.,.,.,.,#,.,#,.,#,.,.,.,#,.,.,.,.,.,.,.,#,.,.,.,#,.,.,.,#,.,#,.,#,.,.,.,#,.,.,.,#,.,.,.,.,.,#,.,#,.,.,.,.,.,.,.,.,.,.,.,.,.,.,.,.,.,#,.,#,.,.,.,#,.,#,.,#,.,#,#
#,#,#,.,#,.,#,.,#,#,#,#,#,.,#,.,#,.,#,#,#,#,#,.,#,.,#,.,#,#,#,#,#,.,#,#,#,#,#,.,#,.,#,#,#,#,#,.,#,#,#,.,#,.,#,#,#,#,#,.,#,.,#,#,#,.,#,.,#,.,#,#,#,.,#,.,#,#,#,#,#,#,#,#,#,.,#,.,#,.,#,#,#,.,#,.,#,.,#,#
#,.,.,.,#,.,.,.,.,.,.,.,#,.,#,.,.,.,#,.,.,.,#,.,#,.,#,.,#,.,.,.,.,.,#,.,.,.,#,.,#,.,#,.,.,.,.,.,#,.,.,.,#,.,.,.,#,.,.,.,#,.,.,.,#,.,.,.,#,.,.,.,#,.,#,.,#,.,.,.,#,.,.,.,.,.,.,.,#,.,#,.,.,.,#,.,.,.,#,#
#,.,#,#,#,#,#,#,#,#,#,.,#,#,#,#,#,.,#,.,#,.,#,.,#,#,#,.,#,.,#,#,#,#,#,.,#,.,#,.,#,.,#,.,#,#,#,#,#,.,#,#,#,#,#,#,#,.,#,#,#,.,#,.,#,#,#,#,#,#,#,.,#,.,#,#,#,.,#,.,#,#,#,#,#,#,#,#,#,#,#,.,#,#,#,#,#,#,#,#
#,.,#,.,.,.,.,.,.,.,#,.,#,.,.,.,#,.,#,.,#,.,.,.,#,.,.,.,#,.,#,.,.,.,#,.,#,.,.,.,#,.,#,.,.,.,.,.,#,.,.,.,.,.,.,.,.,.,#,.,#,.,#,.,.,.,#,.,.,.,.,.,#,.,.,.,#,.,#,.,.,.,.,.,.,.,.,.,.,.,#,.,.,.,.,.,.,.,#,#
#,.,#,.,#,.,#,#,#,.,#,.,#,.,#,.,#,#,#,.,#,#,#,#,#,.,#,#,#,.,#,.,#,.,#,#,#,#,#,.,#,#,#,#,#,.,#,.,#,#,#,#,#,#,#,#,#,#,#,.,#,.,#,#,#,.,#,.,#,#,#,#,#,#,#,.,#,.,#,#,#,#,#,#,#,#,#,#,#,.,#,#,#,#,#,#,#,.,#,#
#,.,#,.,#,.,#,.,#,.,#,.,.,.,#,.,.,.,#,.,.,.,#,.,.,.,#,.,.,.,.,.,#,.,#,.,.,.,#,.,.,.,.,.,#,.,#,.,.,.,.,.,#,.,.,.,#,.,.,.,#,.,.,.,#,.,#,.,.,.,#,.,.,.,#,.,.,.,#,.,.,.,#,.,.,.,.,.,#,.,.,.,.,.,.,.,#,.,#,#
#,.,#,#,#,.,#,.,#,.,#,#,#,#,#,#,#,.,#,#,#,.,#,.,#,#,#,.,#,#,#,#,#,.,#,.,#,.,#,#,#,#,#,.,#,#,#,.,#,#,#,.,#,.,#,.,#,.,#,#,#,#,#,.,#,.,#,#,#,.,#,.,#,.,#,#,#,#,#,.,#,.,#,#,#,#,#,.,#,#,#,#,#,#,#,.,#,.,#,#
#,.,.,.,.,.,#,.,.,.,#,.,.,.,.,.,.,.,.,.,.,.,#,.,#,.,.,.,#,.,.,.,.,.,#,.,#,.,.,.,.,.,#,.,.,.,#,.,.,.,#,.,.,.,#,.,#,.,.,.,.,.,.,.,#,.,.,.,#,.,#,.,#,.,.,.,.,.,.,.,#,.,.,.,.,.,.,.,#,.,.,.,.,.,.,.,#,.,#,#
#,#,#,#,#,#,#,.,#,#,#,#,#,#,#,#,#,#,#,#,#,#,#,.,#,.,#,#,#,.,#,#,#,.,#,.,#,#,#,#,#,.,#,#,#,.,#,.,#,.,#,#,#,#,#,.,#,#,#,.,#,#,#,#,#,#,#,.,#,.,#,#,#,.,#,#,#,#,#,#,#,#,#,#,#,#,#,.,#,.,#,#,#,#,#,.,#,.,#,#
#,.,.,.,.,.,#,.,.,.,.,.,.,.,.,.,.,.,.,.,.,.,.,.,#,.,#,.,.,.,#,.,.,.,#,.,.,.,.,.,#,.,#,.,.,.,#,.,#,.,.,.,.,.,#,.,.,.,#,.,.,.,#,.,.,.,.,.,#,.,.,.,#,.,.,.,.,.,#,.,.,.,#,.,.,.,#,.,#,.,.,.,#,.,.,.,#,.,#,#
#,.,#,.,#,#,#,#,#,#,#,#,#,#,#,#,#,#,#,#,#,#,#,#,#,.,#,.,#,#,#,.,#,#,#,.,#,#,#,#,#,.,#,.,#,#,#,.,#,#,#,#,#,.,#,#,#,.,#,#,#,#,#,.,#,#,#,#,#,#,#,.,#,#,#,#,#,.,#,.,#,.,#,.,#,.,#,.,#,#,#,.,#,#,#,#,#,.,#,#
#,.,#,.,.,.,.,.,#,.,.,.,.,.,.,.,.,.,#,.,.,.,.,.,#,.,#,.,.,.,#,.,#,.,.,.,#,.,.,.,.,.,#,.,#,.,.,.,.,.,.,.,#,.,#,.,#,.,.,.,.,.,.,.,#,.,.,.,.,.,#,.,#,.,.,.,.,.,#,.,#,.,.,.,#,.,#,.,.,.,#,.,.,.,#,.,.,.,#,#
#,.,#,#,#,#,#,.,#,.,#,.,#,#,#,#,#,.,#,.,#,#,#,.,#,.,#,#,#,.,#,.,#,.,#,#,#,.,#,#,#,#,#,.,#,.,#,#,#,#,#,#,#,.,#,.,#,.,#,#,#,#,#,#,#,.,#,.,#,#,#,.,#,.,#,#,#,#,#,.,#,#,#,#,#,#,#,#,#,.,#,#,#,.,#,.,#,#,#,#
#,.,#,.,.,.,#,.,.,.,#,.,.,.,#,.,.,.,#,.,#,.,#,.,.,.,#,.,.,.,#,.,#,.,.,.,#,.,.,.,.,.,#,.,#,.,.,.,#,.,.,.,.,.,#,.,.,.,#,.,.,.,#,.,.,.,#,.,.,.,#,.,.,.,#,.,.,.,.,.,#,.,.,.,.,.,.,.,.,.,.,.,#,.,#,.,#,.,#,#
#,.,#,#,#,.,#,#,#,#,#,#,#,.,#,#,#,#,#,.,#,.,#,#,#,#,#,.,#,#,#,#,#,#,#,.,#,#,#,#,#,.,#,.,#,#,#,#,#,.,#,#,#,#,#,.,#,#,#,.,#,.,#,.,#,#,#,#,#,.,#,#,#,#,#,.,#,.,#,#,#,.,#,#,#,#,#,#,#,#,#,#,#,.,#,.,#,.,#,#
#,.,.,.,#,.,.,.,#,.,.,.,#,.,.,.,.,.,.,.,.,.,.,.,.,.,#,.,.,.,.,.,.,.,#,.,.,.,.,.,#,.,#,.,.,.,.,.,#,.,.,.,.,.,#,.,.,.,#,.,#,.,#,.,#,.,.,.,.,.,#,.,.,.,#,.,#,.,.,.,#,.,.,.,.,.,.,.,.,.,#,.,.,.,#,.,#,.,#,#
#,#,#,.,#,#,#,.,#,.,#,.,#,#,#,#,#,#,#,#,#,#,#,.,#,#,#,#,#,#,#,#,#,.,#,#,#,#,#,.,#,.,#,#,#,#,#,.,#,#,#,#,#,.,#,#,#,#,#,.,#,.,#,.,#,.,#,#,#,.,#,#,#,.,#,.,#,#,#,.,#,#,#,#,#,#,#,#,#,.,#,.,#,#,#,.,#,.,#,#
#,.,#,.,.,.,#,.,.,.,#,.,#,.,.,.,.,.,.,.,#,.,.,.,#,.,.,.,.,.,#,.,.,.,#,.,.,.,.,.,#,.,#,.,.,.,#,.,#,.,.,.,.,.,#,.,.,.,.,.,#,.,.,.,#,.,.,.,#,.,.,.,#,.,.,.,#,.,.,.,#,.,#,.,.,.,.,.,#,.,#,.,.,.,#,.,#,.,#,#
#,.,#,#,#,.,#,#,#,#,#,.,#,.,#,#,#,#,#,.,#,#,#,#,#,.,#,#,#,.,#,.,#,#,#,.,#,#,#,#,#,.,#,.,#,#,#,.,#,.,#,#,#,.,#,.,#,#,#,#,#,#,#,#,#,#,#,.,#,#,#,.,#,#,#,#,#,.,#,.,#,.,#,.,#,.,#,#,#,.,#,#,#,.,#,.,#,.,#,#
#,.,.,.,#,.,.,.,#,.,.,.,#,.,.,.,#,.,.,.,.,.,#,.,.,.,#,.,.,.,#,.,.,.,.,.,.,.,#,.,.,.,#,.,.,.,#,.,.,.,#,.,#,.,#,.,#,.,#,.,.,.,.,.,.,.,#,.,#,.,#,.,#,.,.,.,.,.,#,.,.,.,#,.,#,.,.,.,.,.,#,.,.,.,#,.,.,.,#,#
#,#,#,.,#,#,#,.,#,.,#,#,#,#,#,.,#,#,#,#,#,.,#,.,#,#,#,.,#,#,#,.,#,#,#,#,#,#,#,.,#,#,#,#,#,.,#,#,#,#,#,.,#,.,#,.,#,.,#,.,#,#,#,#,#,.,#,.,#,.,#,.,#,.,#,#,#,#,#,#,#,.,#,.,#,#,#,#,#,#,#,.,#,#,#,#,#,.,#,#
#,.,.,.,.,.,#,.,#,.,.,.,.,.,#,.,.,.,.,.,#,.,.,.,#,.,#,.,.,.,#,.,.,.,#,.,.,.,.,.,#,.,.,.,.,.,#,.,.,.,#,.,#,.,#,.,#,.,.,.,#,.,#,.,.,.,#,.,#,.,#,.,.,.,#,.,.,.,.,.,.,.,#,.,.,.,.,.,.,.,#,.,#,.,.,.,.,.,#,#
#,.,#,.,#,#,#,.,#,#,#,#,#,.,#,#,#,#,#,.,#,#,#,#,#,.,#,#,#,.,#,#,#,.,#,.,#,#,#,#,#,#,#,.,#,.,#,.,#,.,#,.,#,.,#,.,#,.,#,#,#,.,#,.,#,#,#,.,#,.,#,.,#,#,#,#,#,#,#,#,#,#,#,#,#,#,#,.,#,#,#,.,#,.,#,#,#,#,#,#
#,.,#,.,#,.,.,.,#,.,.,.,#,.,#,.,.,.,#,.,#,.,.,.,.,.,#,.,.,.,#,.,#,.,#,.,#,.,#,.,.,.,.,.,#,.,#,.,#,.,.,.,#,.,#,.,#,.,.,.,.,.,#,.,#,.,.,.,#,.,.,.,#,.,.,.,#,.,.,.,.,.,.,.,.,.,#,.,#,.,.,.,#,.,.,.,.,.,#,#
#,.,#,.,#,.,#,#,#,.,#,.,#,.,#,.,#,.,#,.,#,.,#,#,#,#,#,.,#,#,#,.,#,.,#,.,#,.,#,.,#,.,#,#,#,.,#,.,#,#,#,#,#,.,#,.,#,#,#,#,#,.,#,.,#,.,#,#,#,#,#,#,#,.,#,.,#,.,#,#,#,#,#,#,#,.,#,.,#,.,#,.,#,#,#,#,#,.,#,#
#,.,#,.,#,.,#,.,.,.,#,.,#,.,#,.,#,.,.,.,#,.,#,.,.,.,#,.,#,.,.,.,.,.,#,.,#,.,.,.,#,.,.,.,#,.,#,.,#,.,.,.,.,.,#,.,.,.,#,.,.,.,#,.,#,.,#,.,.,.,.,.,.,.,#,.,#,.,#,.,.,.,#,.,.,.,#,.,#,.,#,.,.,.,.,.,#,.,#,#
#,.,#,#,#,.,#,.,#,#,#,.,#,.,#,.,#,#,#,#,#,.,#,.,#,.,#,.,#,#,#,#,#,#,#,.,#,#,#,.,#,#,#,.,#,.,#,.,#,.,#,#,#,#,#,#,#,.,#,#,#,#,#,.,#,.,#,.,#,#,#,#,#,#,#,.,#,.,#,.,#,.,#,.,#,#,#,.,#,.,#,#,#,#,#,#,#,.,#,#
#,.,.,.,#,.,.,.,#,.,#,.,.,.,#,.,.,.,#,.,.,.,.,.,#,.,.,.,.,.,#,.,.,.,#,.,.,.,#,.,#,.,.,.,#,.,#,.,#,.,.,.,.,.,#,.,.,.,#,.,.,.,#,.,#,.,.,.,#,.,.,.,#,.,.,.,#,.,#,.,#,.,#,.,.,.,#,.,#,.,.,.,.,.,.,.,#,.,#,#
#,.,#,.,#,#,#,#,#,.,#,#,#,.,#,#,#,.,#,#,#,.,#,#,#,#,#,#,#,.,#,.,#,.,#,#,#,.,#,#,#,.,#,#,#,.,#,.,#,#,#,#,#,.,#,.,#,#,#,.,#,.,#,.,#,#,#,#,#,#,#,.,#,.,#,#,#,.,#,.,#,#,#,#,#,.,#,.,#,#,#,#,#,#,#,.,#,.,#,#
#,.,#,.,.,.,.,.,.,.,.,.,.,.,.,.,#,.,.,.,#,.,.,.,#,.,.,.,#,.,.,.,#,.,.,.,.,.,#,.,.,.,#,.,#,.,#,.,#,.,.,.,.,.,#,.,.,.,#,.,#,.,#,.,.,.,.,.,.,.,#,.,#,.,.,.,.,.,#,.,.,.,.,.,#,.,#,.,#,.,.,.,.,.,#,.,#,.,#,#
#,.,#,#,#,#,#,#,#,#,#,#,#,#,#,#,#,#,#,.,#,#,#,#,#,.,#,.,#,#,#,#,#,#,#,#,#,#,#,.,#,#,#,.,#,.,#,.,#,.,#,#,#,#,#,#,#,.,#,.,#,.,#,.,#,.,#,#,#,.,#,.,#,#,#,#,#,#,#,.,#,#,#,.,#,.,#,.,#,.,#,#,#,.,#,.,#,.,#,#
#,.,#,.,.,.,.,.,.,.,.,.,#,.,.,.,.,.,.,.,#,.,.,.,.,.,#,.,.,.,.,.,.,.,.,.,.,.,#,.,.,.,#,.,.,.,.,.,#,.,#,.,.,.,.,.,#,.,.,.,#,.,#,.,#,.,#,.,#,.,.,.,.,.,.,.,#,.,.,.,#,.,#,.,#,.,.,.,#,.,.,.,#,.,#,.,.,.,#,#
#,.,#,.,#,#,#,#,#,#,#,.,#,.,#,#,#,#,#,#,#,.,#,#,#,#,#,#,#,#,#,#,#,#,#,#,#,.,#,.,#,.,#,#,#,#,#,#,#,.,#,#,#,#,#,.,#,#,#,#,#,.,#,.,#,.,#,.,#,#,#,#,#,#,#,.,#,#,#,.,#,.,#,.,#,#,#,#,#,.,#,.,#,#,#,#,#,#,#,#
#,.,#,.,#,.,.,.,.,.,#,.,#,.,#,.,.,.,.,.,#,.,.,.,#,.,#,.,.,.,.,.,.,.,#,.,.,.,#,.,#,.,#,.,.,.,.,.,#,.,.,.,#,.,.,.,#,.,.,.,.,.,#,.,#,.,#,.,.,.,.,.,.,.,#,.,.,.,#,.,.,.,#,.,#,.,.,.,.,.,#,.,.,.,.,.,.,.,#,#
#,.,#,.,#,.,#,#,#,.,#,.,#,.,#,.,#,#,#,.,#,#,#,.,#,.,#,.,#,#,#,#,#,.,#,.,#,#,#,#,#,.,#,.,#,#,#,.,#,#,#,.,#,.,#,.,#,.,#,#,#,#,#,#,#,.,#,.,#,#,#,.,#,.,#,#,#,.,#,#,#,.,#,.,#,.,#,#,#,#,#,#,#,.,#,#,#,.,#,#
#,.,#,.,#,.,.,.,#,.,.,.,.,.,#,.,#,.,.,.,.,.,#,.,#,.,.,.,#,.,#,.,.,.,#,.,.,.,.,.,#,.,.,.,.,.,#,.,.,.,#,.,.,.,#,.,#,.,.,.,#,.,.,.,.,.,#,.,#,.,.,.,#,.,.,.,#,.,.,.,#,.,#,.,#,.,.,.,#,.,#,.,.,.,#,.,.,.,#,#
#,#,#,.,#,#,#,.,#,#,#,#,#,#,#,.,#,.,#,#,#,.,#,.,#,.,#,#,#,.,#,.,#,#,#,#,#,#,#,.,#,#,#,.,#,#,#,#,#,.,#,#,#,.,#,#,#,#,#,.,#,.,#,#,#,#,#,.,#,.,#,#,#,#,#,.,#,#,#,.,#,.,#,.,#,#,#,.,#,.,#,.,#,#,#,#,#,#,#,#
#,.,.,.,#,.,#,.,.,.,.,.,#,.,.,.,#,.,.,.,#,.,#,.,#,.,#,.,.,.,#,.,.,.,.,.,.,.,#,.,.,.,#,.,#,.,.,.,.,.,.,.,#,.,#,.,.,.,.,.,#,.,.,.,.,.,#,.,#,.,#,.,.,.,#,.,#,.,#,.,#,.,#,.,.,.,#,.,#,.,#,.,.,.,.,.,.,.,#,#
#,.,#,#,#,.,#,.,#,#,#,#,#,.,#,#,#,#,#,.,#,#,#,.,#,.,#,.,#,.,#,#,#,#,#,.,#,.,#,#,#,.,#,.,#,.,#,#,#,#,#,#,#,.,#,.,#,#,#,#,#,.,#,#,#,.,#,.,#,.,#,.,#,.,#,.,#,.,#,.,#,#,#,.,#,.,#,.,#,.,#,#,#,#,#,#,#,.,#,#
#,.,#,.,.,.,#,.,#,.,.,.,.,.,#,.,.,.,#,.,.,.,.,.,#,.,#,.,#,.,.,.,.,.,#,.,#,.,#,.,.,.,#,.,#,.,#,.,.,.,.,.,#,.,#,.,.,.,.,.,#,.,.,.,#,.,#,.,#,.,#,.,#,.,#,.,.,.,#,.,.,.,#,.,#,.,.,.,#,.,.,.,.,.,.,.,#,.,#,#
#,.,#,.,#,#,#,.,#,.,#,#,#,#,#,#,#,.,#,#,#,#,#,#,#,.,#,#,#,.,#,#,#,.,#,.,#,#,#,.,#,#,#,.,#,.,#,.,#,#,#,.,#,.,#,#,#,#,#,.,#,#,#,#,#,.,#,.,#,.,#,.,#,.,#,#,#,#,#,#,#,.,#,.,#,#,#,#,#,#,#,.,#,.,#,#,#,.,#,#
#,.,#,.,.,.,.,.,#,.,#,.,.,.,.,.,.,.,.,.,#,.,.,.,#,.,.,.,.,.,#,.,.,.,#,.,.,.,#,.,#,.,.,.,#,.,.,.,.,.,#,.,.,.,#,.,.,.,.,.,#,.,.,.,.,.,#,.,#,.,#,.,#,.,#,.,.,.,.,.,.,.,#,.,.,.,#,.,.,.,.,.,#,.,#,.,.,.,#,#
#,.,#,#,#,#,#,#,#,.,#,.,#,.,#,#,#,#,#,.,#,.,#,.,#,#,#,#,#,#,#,.,#,#,#,#,#,.,#,.,#,#,#,.,#,#,#,#,#,#,#,#,#,#,#,.,#,#,#,#,#,.,#,#,#,#,#,.,#,.,#,.,#,.,#,.,#,#,#,#,#,#,#,#,#,.,#,.,#,#,#,#,#,.,#,.,#,#,#,#
#,.,.,.,#,.,.,.,.,.,#,.,#,.,#,.,.,.,.,.,#,.,#,.,.,.,#,.,.,.,.,.,#,.,.,.,.,.,#,.,.,.,#,.,.,.,.,.,#,.,.,.,.,.,.,.,#,.,.,.,#,.,.,.,.,.,#,.,#,.,.,.,#,.,.,.,.,.,.,.,.,.,.,.,#,.,.,.,#,.,.,.,#,.,#,.,.,.,#,#
#,#,#,.,#,.,#,#,#,#,#,#,#,.,#,.,#,#,#,#,#,#,#,#,#,.,#,.,#,#,#,#,#,.,#,#,#,.,#,#,#,.,#,#,#,#,#,.,#,.,#,#,#,#,#,#,#,.,#,.,#,.,#,#,#,.,#,.,#,#,#,#,#,#,#,#,#,#,#,#,#,#,#,.,#,#,#,#,#,.,#,#,#,.,#,#,#,.,#,#
#,.,.,.,#,.,#,.,.,.,.,.,.,.,#,.,.,.,#,.,.,.,.,.,#,.,.,.,#,.,.,.,.,.,#,.,.,.,#,.,#,.,#,.,.,.,#,.,#,.,#,.,.,.,#,.,.,.,#,.,#,.,#,.,#,.,#,.,.,.,.,.,#,.,.,.,#,.,.,.,.,.,#,.,.,.,#,.,.,.,.,.,.,.,#,.,.,.,#,#
#,.,#,#,#,.,#,.,#,#,#,#,#,#,#,#,#,.,#,.,#,#,#,.,#,#,#,#,#,.,#,#,#,#,#,#,#,.,#,.,#,.,#,.,#,.,#,#,#,.,#,.,#,.,#,#,#,.,#,.,#,.,#,.,#,.,#,#,#,#,#,#,#,.,#,.,#,.,#,#,#,.,#,#,#,.,#,#,#,#,#,#,#,#,#,.,#,.,#,#
#,.,.,.,#,.,#,.,#,.,.,.,#,.,.,.,#,.,.,.,#,.,.,.,#,.,.,.,#,.,#,.,.,.,.,.,#,.,#,.,#,.,#,.,#,.,.,.,#,.,.,.,#,.,.,.,#,.,#,.,#,.,#,.,#,.,.,.,.,.,.,.,.,.,#,.,.,.,.,.,#,.,#,.,.,.,.,.,.,.,.,.,.,.,#,.,#,.,#,#
#,.,#,.,#,.,#,.,#,.,#,.,#,.,#,.,#,#,#,#,#,.,#,#,#,.,#,.,#,.,#,.,#,#,#,.,#,.,#,.,#,.,#,.,#,#,#,.,#,#,#,#,#,#,#,.,#,.,#,#,#,.,#,.,#,#,#,#,#,#,#,#,#,#,#,#,#,#,#,.,#,.,#,#,#,#,#,#,#,#,#,#,#,.,#,.,#,.,#,#
#,.,#,.,.,.,#,.,.,.,#,.,#,.,#,.,#,.,.,.,.,.,#,.,.,.,#,.,#,.,#,.,.,.,#,.,#,.,.,.,#,.,#,.,#,.,#,.,.,.,#,.,.,.,#,.,#,.,.,.,.,.,#,.,.,.,#,.,.,.,.,.,#,.,.,.,#,.,.,.,#,.,.,.,.,.,#,.,.,.,.,.,.,.,#,.,#,.,#,#
#,.,#,#,#,#,#,#,#,#,#,.,#,.,#,.,#,.,#,#,#,#,#,.,#,#,#,.,#,.,#,#,#,.,#,.,#,#,#,#,#,.,#,.,#,.,#,#,#,.,#,.,#,.,#,.,#,.,#,#,#,#,#,.,#,.,#,.,#,.,#,#,#,.,#,.,#,#,#,#,#,#,#,.,#,.,#,.,#,#,#,#,#,.,#,.,#,#,#,#
#,.,.,.,.,.,.,.,.,.,.,.,#,.,#,.,#,.,.,.,#,.,.,.,.,.,#,.,.,.,#,.,.,.,#,.,.,.,.,.,#,.,#,.,.,.,.,.,#,.,.,.,#,.,.,.,#,.,#,.,.,.,.,.,#,.,.,.,#,.,#,.,.,.,#,.,#,.,.,.,.,.,#,.,#,.,#,.,#,.,.,.,#,.,#,.,.,.,#,#
#,#,#,#,#,#,#,#,#,#,#,#,#,.,#,#,#,#,#,.,#,.,#,#,#,.,#,.,#,#,#,.,#,#,#,#,#,#,#,.,#,.,#,#,#,#,#,.,#,#,#,#,#,#,#,#,#,.,#,#,#,#,#,#,#,#,#,#,#,.,#,.,#,#,#,.,#,.,#,#,#,.,#,#,#,.,#,#,#,.,#,.,#,.,#,#,#,.,#,#
#,.,.,.,.,.,.,.,#,.,.,.,.,.,.,.,.,.,#,.,#,.,.,.,#,.,#,.,#,.,.,.,#,.,.,.,#,.,.,.,#,.,.,.,#,.,#,.,#,.,.,.,.,.,.,.,#,.,.,.,.,.,.,.,.,.,.,.,.,.,#,.,#,.,.,.,.,.,#,.,#,.,.,.,#,.,#,.,.,.,#,.,#,.,.,.,#,.,#,#
#,.,#,#,#,#,#,.,#,.,#,#,#,#,#,#,#,.,#,.,#,#,#,#,#,.,#,#,#,.,#,#,#,.,#,.,#,.,#,#,#,.,#,.,#,.,#,.,#,#,#,#,#,.,#,.,#,#,#,#,#,#,#,#,#,#,#,#,#,.,#,.,#,#,#,#,#,#,#,.,#,#,#,.,#,.,#,.,#,#,#,.,#,#,#,.,#,.,#,#
#,.,.,.,#,.,#,.,.,.,#,.,.,.,.,.,#,.,#,.,.,.,.,.,.,.,#,.,.,.,#,.,.,.,#,.,.,.,.,.,.,.,#,.,.,.,#,.,#,.,.,.,#,.,#,.,.,.,.,.,.,.,.,.,#,.,.,.,.,.,#,.,.,.,#,.,.,.,.,.,.,.,#,.,#,.,#,.,#,.,.,.,#,.,#,.,#,.,#,#
#,#,#,.,#,.,#,#,#,#,#,.,#,#,#,.,#,.,#,#,#,#,#,#,#,.,#,.,#,.,#,#,#,#,#,#,#,#,#,#,#,#,#,#,#,.,#,.,#,.,#,.,#,#,#,#,#,#,#,#,#,#,#,.,#,.,#,#,#,#,#,.,#,.,#,.,#,.,#,.,#,#,#,.,#,.,#,.,#,.,#,#,#,.,#,.,#,.,#,#
#,.,#,.,#,.,.,.,.,.,#,.,#,.,.,.,#,.,.,.,.,.,.,.,#,.,#,.,#,.,#,.,.,.,.,.,.,.,.,.,#,.,.,.,.,.,#,.,.,.,#,.,#,.,.,.,#,.,.,.,#,.,.,.,#,.,#,.,.,.,#,.,#,.,#,.,#,.,#,.,#,.,.,.,#,.,#,.,#,.,#,.,.,.,.,.,#,.,#,#
#,.,#,.,#,#,#,.,#,.,#,#,#,.,#,.,#,#,#,.,#,#,#,#,#,.,#,.,#,#,#,.,#,#,#,#,#,#,#,.,#,.,#,#,#,#,#,#,#,#,#,.,#,.,#,.,#,.,#,.,#,.,#,.,#,.,#,.,#,.,#,#,#,.,#,#,#,.,#,#,#,.,#,#,#,.,#,.,#,.,#,.,#,#,#,#,#,.,#,#
#,.,.,.,#,.,.,.,#,.,.,.,.,.,#,.,.,.,#,.,#,.,.,.,.,.,#,.,#,.,.,.,#,.,.,.,#,.,.,.,#,.,.,.,#,.,.,.,.,.,#,.,.,.,#,.,.,.,#,.,#,.,#,.,#,.,#,.,#,.,.,.,.,.,#,.,.,.,#,.,.,.,#,.,.,.,.,.,#,.,#,.,.,.,.,.,.,.,#,#
#,.,#,#,#,.,#,#,#,#,#,#,#,#,#,#,#,.,#,.,#,.,#,#,#,#,#,.,#,.,#,#,#,.,#,#,#,.,#,#,#,#,#,#,#,.,#,#,#,.,#,#,#,#,#,#,#,#,#,.,#,.,#,.,#,.,#,.,#,#,#,#,#,#,#,.,#,.,#,.,#,#,#,#,#,#,#,#,#,.,#,#,#,#,#,#,#,.,#,#
#,.,#,.,.,.,.,.,.,.,#,.,#,.,.,.,#,.,#,.,#,.,.,.,.,.,#,.,.,.,#,.,.,.,.,.,#,.,.,.,.,.,#,.,.,.,#,.,#,.,.,.,.,.,.,.,#,.,.,.,#,.,#,.,#,.,#,.,.,.,#,.,.,.,.,.,#,.,#,.,#,.,.,.,.,.,.,.,#,.,.,.,#,.,.,.,#,.,#,#
#,.,#,#,#,.,#,#,#,.,#,.,#,.,#,.,#,.,#,.,#,#,#,#,#,.,#,#,#,#,#,.,#,#,#,.,#,#,#,#,#,.,#,.,#,#,#,.,#,#,#,#,#,#,#,.,#,.,#,#,#,.,#,#,#,.,#,#,#,.,#,.,#,#,#,#,#,.,#,.,#,.,#,#,#,#,#,.,#,#,#,.,#,.,#,.,#,.,#,#
#,.,.,.,#,.,#,.,.,.,#,.,.,.,#,.,.,.,#,.,.,.,.,.,.,.,#,.,#,.,.,.,#,.,.,.,.,.,#,.,.,.,#,.,.,.,#,.,.,.,.,.,.,.,#,.,#,.,#,.,.,.,.,.,.,.,#,.,.,.,#,.,#,.,.,.,#,.,#,.,.,.,#,.,.,.,#,.,.,.,#,.,.,.,#,.,#,.,#,#
#,#,#,.,#,#,#,.,#,#,#,.,#,#,#,#,#,#,#,#,#,#,#,#,#,#,#,.,#,.,#,#,#,.,#,#,#,#,#,.,#,.,#,#,#,.,#,.,#,#,#,#,#,.,#,.,#,.,#,.,#,#,#,#,#,#,#,.,#,#,#,.,#,.,#,.,#,.,#,#,#,#,#,.,#,#,#,#,#,.,#,.,#,#,#,.,#,.,#,#
#,.,#,.,.,.,.,.,#,.,.,.,#,.,.,.,.,.,.,.,.,.,#,.,.,.,.,.,#,.,.,.,#,.,.,.,#,.,.,.,#,.,.,.,#,.,#,.,.,.,.,.,#,.,#,.,#,.,#,.,#,.,.,.,.,.,#,.,#,.,.,.,#,.,#,.,.,.,.,.,.,.,.,.,#,.,.,.,#,.,#,.,#,.,.,.,#,.,#,#
#,.,#,#,#,#,#,#,#,.,#,#,#,.,#,#,#,.,#,#,#,.,#,#,#,.,#,#,#,.,#,#,#,#,#,.,#,.,#,#,#,.,#,#,#,.,#,#,#,#,#,.,#,.,#,.,#,.,#,.,#,.,#,.,#,#,#,.,#,.,#,#,#,#,#,#,#,#,#,#,#,#,#,#,#,.,#,.,#,.,#,.,#,.,#,#,#,.,#,#
#,.,.,.,.,.,.,.,#,.,#,.,.,.,#,.,#,.,#,.,.,.,.,.,#,.,.,.,.,.,#,.,.,.,#,.,#,.,#,.,.,.,#,.,.,.,.,.,.,.,.,.,#,.,#,.,#,.,#,.,#,.,#,.,#,.,.,.,#,.,.,.,.,.,.,.,.,.,#,.,.,.,.,.,.,.,#,.,.,.,#,.,#,.,.,.,#,.,#,#
#,.,#,#,#,.,#,#,#,.,#,.,#,#,#,.,#,.,#,#,#,#,#,.,#,.,#,#,#,#,#,.,#,.,#,.,#,.,#,#,#,#,#,.,#,#,#,#,#,#,#,#,#,.,#,.,#,.,#,.,#,#,#,.,#,.,#,#,#,#,#,.,#,#,#,#,#,.,#,.,#,#,#,#,#,#,#,#,#,#,#,#,#,.,#,.,#,#,#,#
#,.,.,.,#,.,.,.,.,.,#,.,#,.,.,.,#,.,.,.,#,.,.,.,#,.,.,.,#,.,.,.,#,.,.,.,#,.,.,.,.,.,.,.,#,.,.,.,#,.,.,.,.,.,#,.,#,.,#,.,.,.,.,.,#,.,.,.,.,.,#,.,#,.,.,.,#,.,#,.,#,.,.,.,.,.,.,.,.,.,.,.,#,.,#,.,.,.,#,#
#,#,#,.,#,#,#,#,#,#,#,.,#,#,#,.,#,#,#,.,#,.,#,#,#,#,#,#,#,.,#,#,#,#,#,#,#,#,#,#,#,#,#,#,#,.,#,.,#,#,#,.,#,#,#,.,#,.,#,#,#,#,#,#,#,#,#,#,#,.,#,.,#,.,#,#,#,.,#,.,#,.,#,#,#,#,#,#,#,#,#,.,#,.,#,#,#,.,#,#
#,.,.,.,#,.,.,.,.,.,#,.,.,.,.,.,.,.,#,.,#,.,.,.,.,.,.,.,#,.,.,.,.,.,.,.,.,.,#,.,.,.,.,.,#,.,#,.,.,.,#,.,#,.,.,.,#,.,#,.,.,.,.,.,.,.,.,.,.,.,#,.,#,.,.,.,#,.,#,.,#,.,.,.,.,.,.,.,#,.,.,.,#,.,#,.,.,.,#,#
#,.,#,#,#,.,#,#,#,#,#,#,#,.,#,#,#,#,#,.,#,#,#,#,#,#,#,.,#,.,#,#,#,#,#,.,#,.,#,.,#,.,#,#,#,.,#,#,#,.,#,.,#,.,#,#,#,.,#,.,#,#,#,#,#,#,#,#,#,#,#,.,#,#,#,.,#,.,#,.,#,.,#,#,#,#,#,.,#,.,#,#,#,#,#,.,#,.,#,#
#,.,#,.,.,.,#,.,.,.,.,.,.,.,#,.,.,.,#,.,#,.,.,.,.,.,.,.,#,.,#,.,.,.,.,.,#,.,#,.,#,.,#,.,.,.,#,.,.,.,#,.,#,.,#,.,.,.,#,.,#,.,.,.,#,.,.,.,.,.,#,.,#,.,.,.,#,.,.,.,#,.,.,.,.,.,#,.,#,.,.,.,.,.,.,.,#,.,#,#
#,.,#,.,#,#,#,.,#,#,#,#,#,#,#,.,#,.,#,.,#,.,#,#,#,#,#,#,#,.,#,.,#,#,#,#,#,.,#,#,#,.,#,.,#,#,#,.,#,#,#,#,#,.,#,.,#,#,#,.,#,.,#,#,#,.,#,.,#,#,#,.,#,.,#,#,#,#,#,#,#,#,#,#,#,#,#,.,#,#,#,#,#,#,#,#,#,.,#,#
#,.,#,.,.,.,#,.,#,.,#,.,.,.,.,.,#,.,.,.,#,.,#,.,.,.,.,.,#,.,#,.,#,.,#,.,.,.,#,.,.,.,#,.,#,.,#,.,.,.,.,.,.,.,#,.,.,.,.,.,#,.,.,.,#,.,#,.,#,.,.,.,#,.,.,.,#,.,.,.,.,.,.,.,.,.,.,.,#,.,.,.,#,.,.,.,.,.,#,#
#,.,#,.,#,.,#,.,#,.,#,.,#,#,#,#,#,#,#,#,#,.,#,.,#,.,#,#,#,.,#,.,#,.,#,.,#,#,#,.,#,#,#,.,#,.,#,#,#,#,#,.,#,#,#,#,#,#,#,#,#,.,#,.,#,.,#,.,#,.,#,#,#,.,#,.,#,.,#,.,#,#,#,#,#,#,#,#,#,.,#,#,#,.,#,#,#,#,#,#
#,.,#,.,#,.,.,.,.,.,#,.,.,.,.,.,.,.,#,.,#,.,#,.,#,.,.,.,.,.,#,.,#,.,#,.,.,.,#,.,.,.,#,.,#,.,.,.,.,.,.,.,#,.,.,.,.,.,#,.,.,.,#,.,#,.,#,.,#,.,#,.,.,.,#,.,.,.,#,.,#,.,.,.,#,.,.,.,.,.,.,.,.,.,#,.,.,.,#,#
#,.,#,#,#,#,#,#,#,#,#,#,#,#,#,#,#,.,#,.,#,.,#,#,#,#,#,#,#,#,#,.,#,.,#,#,#,.,#,#,#,.,#,.,#,#,#,#,#,#,#,#,#,.,#,#,#,.,#,.,#,#,#,.,#,.,#,.,#,.,#,#,#,#,#,#,#,#,#,.,#,.,#,.,#,.,#,#,#,#,#,#,#,#,#,.,#,.,#,#
#,.,.,.,.,.,.,.,.,.,.,.,.,.,.,.,.,.,#,.,.,.,.,.,.,.,.,.,.,.,.,.,#,.,.,.,.,.,.,.,.,.,#,.,.,.,.,.,.,.,.,.,.,.,.,.,#,.,.,.,.,.,#,.,.,.,#,.,.,.,.,.,.,.,.,.,.,.,.,.,#,.,#,.,.,.,.,.,.,.,.,.,.,.,.,.,#,e,#,#
#,#,#,#,#,#,#,#,#,#,#,#,#,#,#,#,#,#,#,#,#,#,#,#,#,#,#,#,#,#,#,#,#,#,#,#,#,#,#,#,#,#,#,#,#,#,#,#,#,#,#,#,#,#,#,#,#,#,#,#,#,#,#,#,#,#,#,#,#,#,#,#,#,#,#,#,#,#,#,#,#,#,#,#,#,#,#,#,#,#,#,#,#,#,#,#,#,#,#,#
#,#,#,#,#,#,#,#,#,#,#,#,#,#,#,#,#,#,#,#,#,#,#,#,#,#,#,#,#,#,#,#,#,#,#,#,#,#,#,#,#,#,#,#,#,#,#,#,#,#,#,#,#,#,#,#,#,#,#,#,#,#,#,#,#,#,#,#,#,#,#,#,#,#,#,#,#,#,#,#,#,#,#,#,#,#,#,#,#,#,#,#,#,#,#,#,#,#,#,#
