#,e,#,#,#,#,#,#,#,#
#,.,.,.,#,.,.,.,.,#
#,#,#,.,#,.,#,#,#,#
#,#,#,.,.,.,#,#,#,#
#,#,#,#,.,#,#,#,#,#
#,#,.,.,.,.,.,#,#,#
#,#,.,#,#,#,#,#,#,#
#,#,.,#,#,#,#,#,#,#
#,#,.,.,.,.,.,.,e,#
#,#,#,#,#,#,#,#,#,#
