#,#,#,#,#,#,#,#,#,#
#,.,.,.,#,.,.,.,.,#
#,#,#,.,#,.,#,#,#,#
#,#,#,.,.,.,#,#,#,#
#,#,#,#,.,#,#,#,#,#
#,#,.,.,.,.,.,#,#,#
#,#,.,#,#,#,#,#,#,#
#,#,.,#,#,#,#,#,#,#
#,#,.,.,.,.,.,.,.,#
#,#,#,#,#,#,#,#,#,#
