#,#,#,#,#,#,#,#,#,#,#,#,#,#,#,#,#,#,#,#,#,#,#,#,#,#,#,#,#,#,#,#,#,#,#,#,#,#,#,#,#,#,#,#,#,#,#,#,#,#
#,#,.,#,.,.,#,.,#,.,#,.,#,.,#,.,.,#,.,#,.,#,.,.,.,#,.,.,#,.,.,#,#,#,.,.,.,.,.,#,.,.,#,.,.,.,#,.,.,#
#,.,s,.,#,.,#,.,.,.,#,.,#,.,#,.,#,.,.,.,#,.,#,#,.,.,#,.,.,#,#,.,.,.,.,#,#,.,#,.,#,.,#,.,#,.,.,#,#,#
#,#,.,.,.,.,.,#,#,.,#,#,#,.,#,#,#,.,#,#,.,.,.,.,#,.,#,.,#,#,#,.,.,#,#,.,#,.,#,.,#,#,#,.,#,.,#,#,#,#
#,#,.,.,#,#,.,.,#,.,#,#,.,.,#,#,.,.,.,#,.,#,#,.,#,.,.,.,.,.,#,.,.,#,.,.,#,.,#,.,#,#,.,.,#,.,.,.,#,#
#,#,#,.,.,.,#,.,#,.,.,.,#,.,.,#,.,#,#,.,.,.,#,.,#,.,#,#,#,.,.,#,#,.,.,#,#,#,#,.,#,.,.,#,.,.,#,.,#,#
#,.,.,#,.,#,.,.,#,#,#,#,.,#,.,#,.,.,.,#,#,.,#,.,.,#,.,.,.,#,.,.,.,#,.,.,#,.,.,.,#,.,#,.,.,#,.,.,.,#
#,#,.,#,.,#,.,#,.,.,.,.,.,#,.,.,#,#,.,.,#,.,.,#,.,#,.,#,.,.,#,#,.,.,#,.,#,.,#,.,#,.,.,#,.,#,.,#,.,#
#,.,.,#,.,#,.,#,.,#,.,#,.,.,.,#,.,.,#,.,#,.,#,.,.,.,.,#,#,.,#,.,#,.,#,.,#,.,#,#,#,.,#,.,.,.,#,.,#,#
#,#,#,.,.,#,.,.,.,#,.,.,#,#,#,.,#,.,.,.,#,.,.,#,#,.,#,.,.,.,#,.,.,.,#,.,#,.,.,.,.,.,#,.,#,#,.,.,#,#
#,.,.,#,.,#,.,#,.,.,#,#,.,.,.,.,.,#,#,#,#,#,.,.,.,#,.,.,#,#,.,#,.,#,.,#,.,.,#,.,#,#,#,.,#,.,.,#,.,#
#,#,.,.,.,#,#,.,#,.,.,.,#,.,#,#,.,.,.,.,#,.,#,.,#,.,.,#,#,.,.,#,.,#,.,#,.,#,.,#,.,.,.,.,#,.,#,.,.,#
#,#,#,#,#,.,.,.,.,#,#,.,.,.,#,#,#,#,#,.,.,.,#,.,#,.,#,.,.,.,#,.,.,#,.,.,.,#,.,.,.,#,#,#,.,.,.,.,#,#
#,#,.,.,.,.,#,#,.,.,.,#,#,#,.,#,.,.,.,#,#,.,#,.,#,.,.,#,.,#,.,#,.,#,#,#,#,#,.,#,#,#,.,.,.,#,.,#,.,#
#,.,.,#,.,#,#,#,#,.,#,.,.,.,.,.,#,#,.,.,#,.,.,.,#,.,#,.,.,#,.,#,.,.,.,.,.,.,.,#,.,.,.,#,#,.,#,#,#,#
#,#,.,#,.,.,#,#,#,.,.,.,#,#,#,.,.,#,#,.,#,#,#,#,.,.,#,#,.,.,.,.,.,#,#,#,#,.,#,.,.,#,#,#,.,.,.,#,.,#
#,.,#,.,#,.,.,#,.,#,#,#,.,.,.,#,.,.,#,.,.,.,.,#,.,#,.,.,.,#,#,#,#,.,.,.,.,#,.,#,.,.,.,.,#,#,.,.,.,#
#,#,.,.,.,#,.,#,.,.,.,#,.,#,.,.,#,.,#,#,.,#,.,#,.,#,.,#,#,.,.,.,#,.,#,#,.,.,.,.,#,#,#,.,.,.,.,#,.,#
#,.,.,#,.,#,.,#,.,#,.,.,.,.,#,#,#,.,.,.,#,.,.,#,.,#,.,#,.,.,#,#,#,.,#,.,#,#,#,.,.,.,#,.,#,#,.,#,.,#
#,.,#,.,.,.,.,#,.,.,#,.,#,.,.,.,.,#,#,.,.,#,.,#,.,#,.,.,.,#,.,.,.,.,#,.,#,.,.,#,#,.,.,#,.,.,#,.,.,#
#,.,#,.,#,#,#,.,#,#,#,.,.,#,#,.,#,.,.,#,.,#,.,#,.,.,#,.,#,#,.,#,.,#,.,.,.,#,.,.,.,#,.,.,#,.,.,.,#,#
#,.,#,.,#,.,.,.,.,.,.,#,.,.,#,.,.,.,#,.,.,.,.,.,#,.,.,#,.,.,.,#,#,.,.,#,.,#,.,#,.,.,#,.,#,#,.,#,.,#
#,.,#,#,.,.,#,#,#,#,.,.,#,.,#,#,.,#,.,.,#,#,.,#,.,.,#,.,.,#,#,.,.,.,#,.,.,#,.,#,#,.,#,.,.,.,#,.,.,#
#,.,.,#,.,#,.,.,.,.,#,.,#,.,.,#,.,.,#,.,#,.,.,.,#,.,#,.,#,.,.,.,#,#,.,.,#,.,.,.,#,.,.,#,#,.,#,#,.,#
#,#,.,#,.,#,#,.,#,#,#,.,.,#,.,#,.,#,#,.,.,#,#,#,.,.,#,.,.,#,.,#,.,.,#,.,.,.,#,.,#,.,#,.,#,.,.,#,#,#
#,#,.,#,.,.,#,.,.,.,.,#,.,#,.,#,.,#,.,.,#,.,.,.,.,#,.,#,.,#,.,.,.,#,.,#,#,#,#,.,#,.,#,.,#,#,.,.,.,#
#,#,.,#,.,#,.,.,#,#,.,#,.,#,.,#,.,.,.,#,.,.,#,#,#,.,.,.,.,#,#,.,#,.,.,.,.,.,.,#,#,.,.,.,.,.,#,#,.,#
#,.,.,#,.,.,#,.,#,.,.,#,.,#,.,.,#,.,#,#,#,.,#,.,.,.,#,#,.,.,#,.,#,.,#,.,#,#,.,.,.,#,#,#,.,#,#,#,.,#
#,.,#,.,#,.,.,#,.,.,#,.,.,#,.,#,.,#,#,#,.,.,#,#,#,#,#,#,#,.,#,.,#,.,.,#,.,.,#,#,.,#,.,.,.,.,#,.,.,#
#,.,.,.,.,.,#,.,.,#,.,#,.,.,#,.,.,.,#,.,.,#,.,.,.,.,#,#,.,.,#,.,.,#,.,.,#,.,.,.,.,.,.,#,.,#,.,.,#,#
#,.,#,#,.,#,#,.,#,.,.,.,#,.,.,.,#,.,.,.,#,.,.,#,#,.,.,.,.,#,.,#,.,#,#,.,.,#,#,.,#,#,.,#,#,.,.,#,.,#
#,.,.,.,#,#,.,.,.,.,#,.,.,#,#,#,.,#,#,#,.,#,.,#,.,#,.,#,#,.,.,#,.,.,.,#,.,.,.,#,#,.,.,.,#,.,#,.,.,#
#,#,#,.,.,.,.,#,.,#,.,.,#,.,.,.,.,.,.,.,.,.,.,#,.,#,#,.,#,.,#,#,#,#,.,.,#,#,.,.,.,#,#,#,#,.,#,#,.,#
#,#,.,#,#,.,#,.,#,.,#,.,#,.,#,#,#,#,#,.,#,.,#,#,.,.,.,.,.,.,#,#,.,.,.,#,.,.,#,#,.,.,.,.,.,.,.,.,.,#
#,.,.,.,.,#,#,.,.,.,#,.,#,.,#,.,.,.,.,#,#,.,.,.,#,.,#,#,#,#,.,.,.,#,#,#,#,.,.,.,#,.,#,#,#,#,#,#,#,#
#,#,#,#,.,#,.,.,#,.,.,.,#,.,#,.,#,#,.,#,.,.,#,.,#,.,.,.,.,.,.,#,#,.,.,#,.,.,#,.,.,#,.,.,.,.,.,.,.,#
#,.,.,.,.,#,.,#,#,.,#,#,.,#,.,.,#,.,.,#,#,#,.,.,#,.,#,.,#,.,#,.,.,.,#,#,.,#,#,#,.,.,#,.,#,#,.,#,.,#
#,#,#,.,#,.,#,#,.,.,.,#,.,.,.,#,.,#,.,.,.,.,#,.,#,.,.,#,.,#,.,.,#,.,.,.,.,.,#,.,#,.,#,.,#,.,#,.,.,#
#,#,.,#,#,.,.,.,#,#,.,.,#,.,#,.,.,#,.,#,#,.,#,.,.,#,.,#,.,.,.,#,#,.,#,.,#,#,.,.,.,.,#,.,#,.,.,.,#,#
#,#,.,.,.,.,#,.,#,.,.,#,.,.,.,#,.,.,#,.,.,.,.,#,.,#,.,.,#,#,#,#,.,.,.,#,.,.,.,#,#,.,#,.,.,#,#,#,.,#
#,#,#,.,#,#,.,.,.,#,.,.,#,.,#,.,#,.,.,.,#,#,.,#,.,.,#,.,.,.,.,.,#,#,#,#,.,#,#,.,.,.,.,#,.,.,.,.,#,#
#,.,.,.,#,.,#,.,#,.,#,.,#,.,.,.,.,#,#,.,#,.,.,.,#,.,.,#,#,#,#,.,#,.,.,.,.,.,#,#,#,#,.,#,#,.,#,.,.,#
#,#,.,#,.,.,.,.,#,.,#,.,#,.,#,#,.,.,.,#,.,.,#,.,.,.,#,.,.,.,#,.,.,.,#,#,.,#,.,.,.,#,.,.,.,#,.,#,.,#
#,.,#,.,.,#,#,#,.,.,#,.,#,.,.,#,#,#,.,.,#,#,.,#,.,#,.,.,#,.,.,#,#,.,#,.,#,.,.,#,.,#,#,#,.,#,.,#,.,#
#,.,.,.,#,.,.,#,.,#,#,.,#,#,#,.,.,.,.,#,.,.,.,.,#,#,.,#,.,#,.,#,.,.,.,.,#,.,#,#,.,.,.,#,.,.,.,#,#,#
#,.,#,#,.,#,.,.,.,.,.,.,.,.,.,.,#,#,.,#,.,#,#,.,#,.,.,#,.,#,.,.,#,#,.,#,.,.,#,.,#,#,.,#,.,#,.,.,.,#
#,.,#,.,.,.,.,.,#,#,#,#,.,#,.,#,#,#,.,#,.,#,#,.,#,#,#,#,#,#,#,.,#,#,.,#,#,#,#,.,#,#,.,#,.,#,#,.,#,#
#,.,#,.,.,#,#,.,#,#,#,#,.,.,.,.,#,.,.,.,.,#,#,.,.,.,#,.,.,#,#,.,.,#,.,#,.,.,#,.,#,#,.,.,.,.,#,e,.,#
#,.,#,.,#,.,.,.,.,#,.,.,.,#,#,.,#,.,#,#,.,.,.,#,#,#,.,.,#,.,.,#,.,#,#,.,.,#,.,.,.,.,#,.,#,.,.,.,#,#
#,#,#,#,#,#,#,#,#,#,#,#,#,#,#,#,#,#,#,#,#,#,#,#,#,#,#,#,#,#,#,#,#,#,#,#,#,#,#,#,#,#,#,#,#,#,#,#,#,#