., ., #, ., #
#, ., ., ., #
., ., #, ., #
#, ., ., ., .
#, ., #, #, .
