s, ., #, ., #
#, ., ., ., #
., ., #, ., #
#, ., ., ., .
#, e, #, #, .
