#,s,#,#,#,#,#,#,#
#,.,.,.,#,.,.,.,.
#,#,#,.,#,.,#,#,#
#,#,#,.,.,.,#,#,#
#,#,#,#,.,#,#,#,#
#,#,.,.,.,.,.,#,#
#,#,.,#,#,#,#,#,#
#,#,.,#,#,#,#,#,#
#,#,.,.,.,.,.,.,e
