#,s,#,#,#,#,#,#,#,#
#,.,.,.,#,.,.,.,.,#
#,#,#,.,#,.,#,#,#,#
#,#,#,.,.,.,#,#,#,#
#,#,#,#,.,#,#,#,#,#
#,#,.,.,.,.,.,#,#,#
#,#,.,#,#,#,#,#,#,#
#,#,.,#,#,#,#,#,#,#
#,#,.,.,.,.,.,e,#
#,#,#,#,#,#,#,#,#,#
